{
    "1": "yes",
    "2": "yes",
    "3": "yes",
    "4": "no",
    "5": "yes",
    "6": "yes",
    "7": "no",
    "8": "yes",
    "9": "yes",
    "10": "yes"
}